02 00 00 00 00 00 09 00 00 00 00 00 00 00 00 00 00 00 00 00 00 00 00 00 00 00 00 00 00 00 03
01 15 15 15 15 15 01 15 15 16 15 15 15 16 15 15 15 15 15 15 15 16 15 15 15 15 15 15 15 15 01
01 15 02 00 10 15 01 15 02 00 10 15 11 00 00 09 00 00 10 15 11 00 03 15 12 15 11 00 03 15 01
01 15 13 15 15 15 01 15 01 15 15 15 15 15 15 01 15 15 15 15 15 15 13 15 01 15 15 15 13 15 01
01 15 15 15 11 00 04 15 01 15 02 00 00 10 15 13 15 11 00 00 03 15 15 15 05 00 03 15 15 15 01
06 00 10 15 15 15 15 15 01 15 01 15 15 15 15 15 15 15 15 15 01 15 12 15 15 15 01 15 11 00 07
01 15 15 15 12 15 11 00 04 15 13 15 02 00 10 18 11 00 03 15 13 15 05 00 10 15 01 15 15 15 01
01 16 11 00 07 15 15 15 15 15 15 15 01 18 18 18 18 18 01 15 15 15 15 15 15 15 06 00 10 15 01
01 15 15 15 01 15 11 00 09 00 03 15 05 00 00 09 00 00 04 15 12 15 02 00 10 15 01 15 15 15 01
06 00 10 15 01 15 15 15 01 15 01 15 15 15 15 01 15 15 15 15 01 15 01 15 15 15 01 15 11 00 07
01 15 15 15 06 00 10 15 01 15 05 00 00 10 15 01 15 11 00 00 04 15 01 15 11 00 04 15 15 15 01
01 15 12 15 01 15 15 15 01 15 15 15 15 15 15 01 15 15 15 15 15 15 01 15 15 15 15 15 12 15 01
01 15 13 15 13 15 12 15 05 00 10 15 11 00 00 08 00 00 10 15 02 00 04 15 12 15 11 00 04 15 01
01 15 15 15 15 15 01 15 15 15 15 15 15 15 15 15 15 15 15 15 01 15 15 15 01 15 15 15 15 15 01
05 00 00 00 00 00 08 00 00 00 00 00 00 00 00 00 00 00 00 00 08 00 00 00 08 00 00 00 00 00 04
